type octile
height 100
width 100
map
...@..@.@..@....@.@@.@........@TT@@@@@.@TT@TT@..@@TTTTT@....@@@..@..@@..@...@@...@....@T@.@....@T@..
@....@@.@....@@.@.......@....@TTTT@.@..@TT@TTT@...@@T@@@...@T@.@...@@...........@.....@T@..@....@@@.
..........@.@..@..@@..@....@.@TTT@..@..@T@@@@@...@T@@.@@@...@............@.......@..@.@@....@..@@@..
..@.@......@..@..@.@......@@@T@@@..@....@.@T@...@T@@..@@@..@..@..@.@@@@....@..........@..@@.........
...@.....@......@.........@..@@@..@@..@@...@..@@.@T@...@@.......@..@...@.@.@.@.@@@@@...@.@.@...@.@.@
.@.....@.@@.@@.@.....@.@.@..@T@@...@...@.........@T@@.............@..@@...@T@........@...@.@@@.@....
@.@.......@..@.@@@..@.......@T@@...@...@...@@...@.@T@..@....@..@..@.....@..@.........@..@@...@.@....
..@...@@@.@.@..@....@.....@..@.........@@.@@@.@....@.@...@...@....@.@.@@@..@.........@@@@..@........
..@...@....@@@.......@@@.....@...@....@@....@@.@.@...@......@@@.......@T@..@...@@.@.@.....@....@..@.
@...@.@..@@TT@@@...@...@....@@.@...@..@..@.@@..@...@@..@..@...@@@..@@@T@@.@T@.......@.@.........@.@@
....@......@@@TT@....@..@.@@@.@@.....@@..@@..@.@....@...@@@...@.......@..@TT@@.@.@@...@....@.@@@..@T
..@@@.....@T@TT@T@..@.@........@..................@@T@@.....@....@...@@...@T@...@.@@.@...@@...@.@..@
........@..@TTT@@.........@.@......@.@..@@.@@@.@....@@.@....@.@.@T@......@.@@.......@..@@...@.......
.......@....@T@..@......@@@@..........@@..@.@...........@........@T@..@..@..@......@............@@@@
@...........@T@@.....@..@..@@@@.....@...........@.@...@...@.......@......@...@.@..@T@..@@..@...@..@.
.@...@.@.....@....@@....@.@...@@........@@...@@..@..@..@@@......@.@.......@.@@.@@@@@.@...@...@......
.@.@@@...@@...@@...@@@@......@T@..@@@.@@T@@.@@.@.@.....@..@@.@..............@@.....@...@.@@........@
..@..@.....@...@@......@@.....@..@..@...@......@@@..@.@@..@......@.@.@@.@@....@.@@...@.@..@@.@..@@..
@...@......@...@@...@....@@@....@@@..@....@..@.@.@@@..@..@....@.@@.@.@.@....@....@.....@.@.........@
..@@@...@@..@...@@...@.@......@@.......@....@T@......@...@.@@@@........@@..@@.@.@@..@..@..@....@....
.@.....@@@..@..@T@@...@..@@@.@..@....@.@@.@@.@.@..@@..@......@.....@@@.@@.@..@...@........@.@..@.@.@
.@..........@.@@@.@@....@.@..@..@.@@@....@@..@.......@.@.@....@...@T@@@.........@...@....@@....@@..@
.....@.@....@.@T@.@..@@@........@@....@@@.@@..@..........@@.....@@.@@@@..........@.@.@@...@....@.@.@
@.......@..@@@@@@...@@....@@@....@...@@@...@@.......@..@.......@....@@...@..@...@....@@..@..........
@.@..@.@..@@@@T@@@@@T@.....@....@.@@@@@T@..@@@...@...@...@@.@..@......@....@...@.@.@@@...@@....@....
....@@@@.....@TT@.@TTT@@@.@..@@@..@@T@@T@@..@...@.@@.@.@@........@@@@..@..@@......@T@@....@@.@..@@..
@..@@.@.@@..@@@@@.@TTT@@....@.@..@T@@T@TT@@...........@....@....@@@....@@.@@@....@@@T@.@..@.@@...@@.
...@....@@@...@@@..@@T@.......@...@@T@TTT@T@@....@...@....@...@.....@...@.@..@@...@@@.....@...@....@
@.......@T@...@....@.@.@..@.@....@..@@TTT@@..@.@.@.......@.....@@...@..@.@..........@@@@.@@.....@.@@
...@@@@..@....@......@...@........@...@T@..............@@@..@.@@..@...@.......@..@..@@..........@..@
@@@.@....@.......@......@..@@..@...@..@TT@...@.@@..@.@@.@..@@....@@...@.....@...@...@....@@.........
@.@....@@.@@..@@..@@@@........@...@....@T@................@.....@.@@@...@.@@.@.@@....@@.@@@.......@@
...@@.....@..@.............@@@....@.@...@...@@.@...@.@.........@......@...@..@...@.....@TTT@@@@.@.@.
@@.....@...@...@.@..@..@@......@.@T@@...@.....@....@.@...@.....@.....@..@....@.@.@.@@.@.@@@.@@@@.@..
..@...@.....@..@..@.@....@@..@@.@.@..@..@...@..@..@.........@@.......@....@@.@.....@.....@@...@@....
@...@@@.@..@T@@T@.....@@...@@.@.......@.@............@@.@....@.@@.....@..@@..@@@.@..@..@@...@.@....@
....@T@.....@TTTT@.@@@.@.@.@.....@...@.......@..@.@.@@@...@..........@...@@...@@..@........@@...@...
....@T@.@....@TT@@@@@...@@.@.@..@..@.........@.@.@......@.@.@@@.@.@...@..@@.@@.@.@...@..@..@...@T@..
@@.@.@...@..@TT@@TT@@.....@..@..@....@.@..@..@.@......@.@.@..@..@@..@..@.........@...@@.@.......@.@.
@T@...@....@@@@T@@TT@...@.....@.@@..@..........@@...@.@...@..@.@.....@.....@@...@....@...@.@@.@.....
@@....@..@@..@TT@TT@@.....@..@@@..@.@@@.@....@.@@...@..@..@@...@@....@@@...@.@@@@.@@..@@..@T@.@.....
...@@.@.@.@...@T@TTT@@..@@T@..@....@..@.@@.@...@T@.@@.@....@..@@.....@@@@.@@....@.....@T@@@@@@..@...
..@@@.........@@TTT@@T@.@TT@@.............@..@@@T@..@..@...@@......@.@TT@............@.@..@@...@....
...@...@@.@..@..@@@..@...@@...@..........@...@..@@.@@..@.@.....@......@T@....................@@@....
@.@...@T@...@........@.@@..@.....@..@@...........@..@....@..@..@......@@..@..@..@..@..@@..@..@@.....
.....@.@.@.......@@..@.....@...@.@.@...@.@@.@....@@..@.@.....@.@.@.@...@..@.@.@.@.@@.@....@@..@.@@..
.@.@.....@.@@..@.......@.@...@@.@...@@......@@.@.@....@.....@T@.@...@@....@.......@.....@@@@...@....
@T@...@.@.......@.@@@@.....@....@......@..@.@..@...@.@.@.....@.......@.@.@.@.@@..@..@@.@.@...@...@.@
@@.@...@.......@T@..@..@.......@....@@..@.....@......@......@....@.....@.@...@@.@..@.@...@.@@@.@..@.
.....@........@T@...@.....@@@@.@..@.@@....@.@@@@.@@@...@@..@.....@...@@T@@.....@T@@...@.....@.....@.
..@...@...@.@..@@...@...@......@......@.@@@.@....@@@@.@.@......@@@@.@..@@@.@..@.@.@..@.@@.........@.
@.@@.@.....@....@...@...@.@...@@...@.@@.@T@@..@...@T@.@.@..@..@.........@..@..@.....@......@.@.@@.@.
...@@T@.....@@......@@...@.@...@@.@@.....@....@...@@@@...@.....@....@@@@..@@@@...@.@@.....@..@..@.@.
.@@..@......@@@..@@@...@...@@.@T@@@......@.......@TTT@..@.@@.....@@@TT@@.@T@@@.@.@.....@@..@.@.@.@..
@TT@.....@.@T@@@.@@.@.@.@...@.@@TTT@....@@...@@@..@T@.........@.@...@@....@....@..@@...@.@..@.......
@T@..@@@..@.@@@......@@....@@.@TTT@..@..@T@.@TTT@..@.@@.@.@..@T@.@......@....@..@@.....@.@........@.
@@........@.@.@.@.@...@....@T@@T@@..@@..@@..@TT@@......@@..@.@@..........@....@@@@@@.@...@@..@@.@...
...@@...@@..@....@T@@@@...@.@..@@T@@@@@...@..@@@...@..@..@.@@..@.@...@......@..@...@@T@.@@...@..@..@
@@@@..@......@....@..@T@.@...@.@.@....@@.@...@...@.@@......@..@.@...@......@......@T@@@.@T@...@@....
@..@@@....@@..@.@@...@@............@..@.@...@..@@....@...@..@......@.@.......@@.@@T@TTT@TT@@.@@.....
@@.....@...@.......@.@....@......@.........@..@T@.....@..@@@@...@.......@.@....@@TTTTTTT@@T@.@@...@.
..@@.@....@..@.@@..@...@.@@.......@......@.@.@T@..@.@.@@.@........@..@.....@..@TTTTT@TT@.@@....@....
.@................@T@.@............@..@@@..@@TT@.@@...@@@......@.@@.@@..@@....@@TTT@T@@.....@.@T@...
..@@@@..@...@@.....@T@@@...@.@.@..@..@.....@@@@.@....@@@.....@@.@T@@@.@@@@@.@...@TT@@.....@@@@.@..@.
.@......@..@...@..@.@..@..@T@..@@@@.@..@@..@.@....@@.@@T@.....@..@....@TT@@.@.@..@@.......@....@.@T@
.........@......@........@.@T@....@...@@...@.....@@.@..@@@..@...@....@TTT@.@.....@....@......@.@.@@T
.....@................@@.@..@..@@..@...@...@..@.@@......@T@.@.@.@.@...@@@..@@@@.@@@..@.@@@...@.....@
@@.......@...@.....@..@@.@@....@.....@....@@....@..@.@...@....@.@...@......@@T@@@@..@@............@@
TT@.....@T@.....@@@T@@@.@.@.@...@...@@@......@.@.@....@..@@..@.@..@.@.@.@@...@..@.@...@....@..@....@
TT@...@.@@.....@TTTT@@.......@@...@.@....@..@......@@@@..@T@@@..@.@@...@@@@...@.@....@...@@T@.@@@...
@@..@@@..@@..@@.@T@@T@@..@@@@@..@..@..........@@....@T@...@@.....@@....@...@@...@..@..@..@.@...@....
@T@.@....@..@....@..@.@...@T@@@@...@.@...@.@@@....@..@........@@..@...@.......@.@.@T@.@....@.@....@.
TT@.........@@......@....@@@......@@.....@@@.....@.@..@.@.@.@@..@@.@@.@@.....@@...@@@.@.@...@...@..@
T@.......@..@@...@.....@@@@..@@.....@........@.@@@...@@@......@.@...@.@@.@@...@..@....@@@@.@.@.@....
@.@@@@@..@...@.@........@......@@@@.@.....@.@@..@....@.@@...@...@@...@......@.@...@...@@..@..@@....@
..@@TT@...@.@..@.@@...@@@..@....@TT@T@........@@..@.......@.......@..@....@..@@....@.@...@T@...@....
@..@TTT@.@...@.@@.@...@....@@@..@@TTT@.@.@@....@@...@.@@@......@..@@..@...@....@........@@@T@..@....
..@@@T@....@@T@@......@...@.......@@TT@....@..@T@.@@@...@..@@......@...@.@@@..@@.@.@.@.....@@@...@@.
@...@@...@@..@@.....@.@..@.@.......@T@.@@@....@@@..@T@@..@..@@...@.........@.@@...@...@.....@@@..@..
@@@.....@@...@...@...@@@.@..@.@@@.@@@@.@.@.@@...@.@TT@.......@...@.@..@@.@....@..@@@@..@@@@.@..@.@@@
TT@@@..@@@....@.....@..@@@..@@.......@...@@........@T@.@.....@@.....@@@@.@..........@...@@@@T@.@@.@.
T@@.@@.@@T@..@@.....@@...@.@TT@...@@...@@.....@.....@@@....@..@..@@@.@@.@T@....@.@.....@.@..@.....@.
@@@.....@@....@.............@T@.@.....@@@.@@..............@.@.@@.@.......@@@.@..@@@.@@@..@.@..@.....
TT@....@TT@@...@..@......@@.@T@..@.@.....@..@..@...@.....@...........@@@@@@.@..@@...@...@@...@@.@..@
@TT@....@@..@.......@@..@....@@@@.........@.@..@...@...@@@.@@.@....@....@.....@T@...@...@@.@..@@@@@@
TTTT@......@...@..@@....@.@.@@@@T@....@..@..@..@......@T@..@..@.@@@......@@.@..@..@.....@.....@..@..
@TT@@.....@...@...@@..@@..@@....@@@@..@@.@@...@.@@...@@@....@@.......@...@.....@.@.@.@.@@.........@.
TT@...@............@....@.@@...@...@@@@@..@@@.....@.@..@@...@.@@@.@..@...@..@.@@...@@.@@.@@.........
T@...@T@.@.....@.@@.@..........@......@@..@.@@.................@@.@.......@............@......@.@...
@@@@..@T@...@.@.@.@..@..........@@...@.@....@@@.@...@...@@.@.@.@.@.....@.@...@.....@@@@..@.@...@..@.
.@@@.@@@.@..@@@.........@..@..@@..@........@.@...@@@..@.@...@@.......@.......@@...@@..@......@.@.@@.
.........@@@.@......@....@.@.@@T@.....@.........@@....@@@....@@@@@........@..@...@...@...@..@.@..@@.
.@..@.@......@...@.@..@@@@..@.@@@.....@....@.@...@....@@@@.@@@@..@.@.@....@.@..........@...@.....@..
......@.@.@@....@@..@.@.......@......@@......@...@....@..@@.........@@@.@...............@..@..@@...@
..@.@..@@@.@@.@....@@.@@.....@......@.@@.@@.....@@@..........@........@@...@@..@.@..@..............@
..@@.......@...@.@..@..@....@...@@........@@..@.......@...@.@....@..@@T@@@.................@..@....@
..@@@...@..@@.......@@@@@...........@@.@....@@@@@.....@...@@..@.@@@..@@......@..@......@......@.....
.@@@@.....@@T@.@...@.@@.@@@....@@.@....@...@..........@@@.@@@.@....@...@@@@...@@...................@
@...........@.@.@....@........@......@@@@@@.....@@@....@@.@T@@........@@T@T@........@..@..@@..@.....
@.@.....@........@@......@...@@.....@TT@TT@@@........@@TT@TT@.....@..@TTTTTT@.......@.@.....@..@.@..
